FeatureVariables.h	KEYWORD1
Feature	KEYWORD1
FeatureBase	KEYWORD1

NEW_FEATURE	KEYWORD1
FEATURE_FIRE_EVENTS_SAVE_VALUES	KEYWORD1
FEATURE_DO_NOT_FIRE_EVENTS_OR_SAVE_VALUES	KEYWORD1
FEATURE_DO_NOT_SAVE_VALUES	KEYWORD1
FEATURE_DO_NOT_FIRE_EVENTS	KEYWORD1
FEATURE_DEBUG_OBJECT	KEYWORD1

getName	KEYWORD2
setName	KEYWORD2
getType	KEYWORD2

getValue	KEYWORD2
getPreviousValue	KEYWORD2
setValue	KEYWORD2
toString	KEYWORD2

toJson	KEYWORD2
fromJson	KEYWORD2

allowSaving	KEYWORD2
setSaveTimeout	KEYWORD2
getFilename	KEYWORD2
openValue	KEYWORD2
saveValue	KEYWORD2

allowEvents	KEYWORD2
addEventCallback	KEYWORD2
removeLastCallback	KEYWORD2
removeSpecificCallback	KEYWORD2
removeAllCallbacks	KEYWORD2

setDebugOutput	KEYWORD2